ネット

■ ネットワーク

LAN→家庭やオフィスなど限定されたエリアで接続できるプライベートネットワーク

有線LAN→LANケーブルと呼ばれるインターネット接続のケーブルを使ってインターネットに接続する方法

無線LAN→ケーブルを使わずに無線通信によりインターネットに接続する方法

WAN(ワン)→広範囲にわたるネットワーク。LANとLAN同士を繋ぐ大きなネットワーク

インターネット→世界中のコンピュータなどの情報機器を接続するネットワーク
 


■ ネットワーク構成

ノード→点(装置)とそれを結ぶ線(伝送路)

リンク→何かと何かをつないでいる何か（[パソコン]―[ルータ]―[サーバ]のーの部分がリンク）

トポロジ→ネットワークトポロジーの省略表現。ネットワークの接続形態を点と線でモデル化したもの

バス型トポロジ→1ケーブルを1本用意して、そのケーブルにそれぞれのコンピュータをつなぐ形態のネットワークのこと。不具合が起こると全てダメになってしまう。

スター型トポロジ→すべての通信を元締め経由でやる形態のネットワーク（ハブ経由）小規模の企業や家庭で使用されることが多いです。

メッシュ型トポロジ→線が網の目のように張り巡らされている形態のネットワーク

帯域(タイイキ)→通信するときに使われる電波や光の周波数の範囲のこと（「帯域幅」や「バンド幅」）帯域が広い＝通信速度が速い

bps(ビット)→通信回線などのデータ伝送速度の単位で、1秒間に伝送できるデータのビット数のこと。1bpsは毎秒1ビットのデータを伝送できることを表す。

輻輳(ふくそう)→通信の世界における渋滞。アクセスが集中して、テンパった状態になること

コリジョン→ ネットワーク上の交通事故のこと。ネットワークにおいて、別々のコンピュータから送られたデータ同士がぶつかっちゃうこと

ドメイン→インターネット上の住所

ポート→ネットワークとパソコンの間にあるドア、もしくは接続口のこと 



■ モデル

プロトコル→約束事。通信する上での約束事

OSI参照モデル→「通信機能って、どんな仕組みにするの？」を整理した共通ルールのひとつ。国際標準化機構（ISO）ってところが作ったデータ通信機能におけるモデル(7つの階層)

ヘッダ→そのデータに関する説明書きが書いてあるところ

カプセル化→パケットを包んだパケットにすること

非カプセル化→ヘッダの情報に間違いがないことを確認した後ヘッダを取り外す作業

PDU→OSI参照モデルにおける用語。階層化されたプロトコルの各層で扱われるデータの単位の総称

MTU→通信世界における自動車の車高制限。通信用に細切れにしたデータの大きさ制限で、これくらいの大きさの細切れデータなら通れるよ（送れるよ）な最大値のこと

フレーム→ネットワーク上のデータ単位は、パケットと呼びます。 このパケットの内、データリンク層を流れるデータ単位をフレームと呼びます。

パケット→通信用に細切れにされたデータ。一度にまとめて送ろうとすると、線が詰まってしまう。もしかしたら詰まらないかもしれませんが、なんか大変そう

セグメント→同じような属性を持つ固まりのこと。全体を何らかの条件で分割した際の、それぞれの固まりのこと

TCP/IPモデル→異なるメーカーの製品でも通信できるようにするために作られたルール（モデル）４つの段層



■ 物理層

ビット→コンピュータが扱うデータの最小単位のこと

ツイストペアケーブル→中の銅線が2本一組でぐりぐりとよりあわさっている構造になっているケーブル。ぐりぐりした方がノイズの影響を受けにくい

UTP→2本の銅線をよりあわせて1本にした線（より対線）の分類のひとつ。銅線部分がアルミホイルとかでシールドされていない、より対線のこと。UTPは、シールドありのやつより若干ノイズのガードが弱め。その代わり、お値段設定がリーズナブル

STP→2本の銅線をよりあわせて1本にした線（より対線）の分類のひとつ。銅線部分がアルミホイルとかでシールドされている、より対線のことお値段はシールドしていないやつより高め

カテゴリー→1つはLTE端末の通信性能を示す指標。 もう1つはLANケーブルの伝送性能を表す指標である。LANケーブルの規格のこと、数字が大きくなればなるほど早い。

コネクタ→コンピュータと周辺機器を接続するときに使うケーブルの接続部分のこと

ストレートケーブル→細い線の並びが左端と右端で同じLANケーブル

クロスケーブル→クロスケーブルはパソコン同士をつなぐときに使うLANケーブル。パソコン同士の入力と出力を合わせるため、普通のLANケーブルを使ってつなげると、パソコンの入力と入力、出力と出力がつながってしまう

光ファイバケーブル→中を光信号が通る通信用の線

ハブ→有線LANを構成するための集線装置

半二重通信→トランシーバーっぽい通信のこと。「送っているときは受け取れないよ。受け取っているときは送れないよ（送るのと受けるのを同時にはできないよ）」なやつ



■ データリンク層

イーサネット→「物」に関する規格。LANケーブルとか。TCP/IPは、中を通る「データ」のお話。LANに使われている（主に物理的な部分に関する）通信規格

ファストイーサネット→元来のイーサネットの速度10Mbps(メガビット)に対し、公称100Mbpsの速度でトラフィック(交通量)を伝えるいくつかのイーサネット規格の総称。

ギガビットイーサネット→1Gbpsでやり取りできるよ！な、LANケーブルの接続口の規格

イーサネットヘッダ→ネットワーク上を流れるデータの中身の一部で、イーサネットってお約束事で使う情報が書かれている部分のこと

トレーラ→パケットやフレームなどのデータ伝送単位の末尾にある制御情報などの領域をトレーラーと言うこと

CSMA/CD（シーエスエムエーシーディー）→通信のやり方のひとつで「交通事故が起きたら何とかするよ」方式のこと。
　　　　　　　　　　　　　　　　　　　「通信状況を監視していて、線が空いていたら通信しますよ。運悪くデータ同士の衝突（コリジョン）が発生したら、一旦送るのを止めて、時間を空けて送り直しますよ」な通信方式のこと

MACアドレス→ネットワークで使う機器それぞれに割り当てられた住所。MACアドレスはパソコン（の中の部品）に刻まれた刺青。刻まれちゃっているので、後から変更できません。IPアドレスは変更可能

スイッチ→ネットワークにおける交通整理員さんのこと.ネットワーク中のデータを見て、行き先を振り分けてくれる機器のこと

MACアドレステーブル→ネットワークスイッチなどが内部的に管理している情報で、どのポート（端子）にどのMACアドレスを持つ機器が接続されているかを記録したもの。

フラッディング→ネットワーク機器のデータ転送方式の一種や、システムに許容量を超えるデータや処理要求が届き麻痺状態に陥る現象などをこのように呼ぶ。

全二重通信→「送る」と「受け取る」を同時にできる

VLAN→元々のネットワークを論理的に区切ったりまとめたりしたネットワーク

タグVLAN→データにそのデータが所属するネットワークの情報を付与し、制御する側はその情報を見て所属するネットワークを判断するやり方

ポートベースVLAN→元々のネットワークを論理的に区切ったりまとめたりしたネットワーク

アクセスポート→コンピュータと接続するときに使う穴

トランクポート→スイッチと接続するときに使う穴

DTP→アクセスポートかトランスポートの判断を機器同士で自動で最適な設定を行うプロトコル

デフォルトVLAN→本スイッチの初期状態から存在する VLAN #1 (vlan1) のことです。 デフォルトVLANは特殊なVLANであるため、常に存在し、削除することはできない。

ネイティブVLAN→グ付きポートで受信したタグなしパケットの所属先VLANのこと。 初期状態ではvlan1に設定されているため、タグ付きポートで受信したタグなしパケットはvlan1の所属として扱われる。 これを変更したい場合は本コマンドで別のVLAN IDを指定すること。

ブロードキャストストーム→ネットワーク上で一斉配信(ブロードキャスト)用の特殊なデータや信号が際限なく転送され続ける現象

スパニングツリープロトコル→通信するときに使う約束事（通信プロトコル）のひとつ。ネットワーク内でデータが同じところをぐるぐる回らないようにするための仕組み（スパニングツリー）を実現するときに使うお約束事

リンクアグリゲーション→複数の線を1本の線っぽく扱う技

EtherChannel→リンクアグリゲーションをCiscoでは「EtherChannel」と呼ぶ